20.xx
oo.....o.....oo..o..
ooo...o......o.o...o
ooo...ooo....o......
o.....oo..o..o..oo.o
oo...o...o...oo...oo
......o.oo..o.......
.......o....o..o...o
o.o..o.o...........o
o.o....o..ooooo.....
ooo.o.......o.o..o..
..o...o.ooo.ooo...oo
..o..o..oo.o........
......o..oo...oo.o..
.oo..o.o.o...o..o.o.
oo.oo..o..o..o.ooo.o
o..o.o.o.......o.o..
o..o.o...oo.o.....o.
o.o......oo..o......
..o....oo...o.......
..........o..ooo..oo
