20.ox
ooo.....ooo...o..o..
.o.o.oo...oo......o.
....ooo....o....o...
.oo...oo....oooo....
..o.o.......o...o...
.oo..oo..oo..o...oo.
...oo........o.oo..o
o.o.......o.o...o...
oo.......oooo..o.o.o
ooo...o..o..oooo....
..ooo....o....o...o.
.o....o.o..o.oo...oo
.....o...o......o.o.
....ooo.o......o.o..
.o.oo..o.oo...o...oo
o....oo..o...oo.ooo.
...o.o.....oo.ooo.o.
oo...oo.ooo.o..o...o
..o...ooo....o.o..o.
..o...o..oo.......o.
..o...o..oo.......o.
